11111111111111111111
100000CC0000CCC00001
10000C1C001C010C0001
1000C11C0010101C0001
100C111C0010010C0001
100CCCCCC01000C00001
1000000C00100C000001
1000000C0100C00000E1
1000P00C01CCCCCCCC01
11111111111111111111
