111111111111111
110000001001101
100000000000001
100000011000001
100000000000001
100000000000001
111111111111111
