111111111111111
110P000011111C1
100010C00000001
101111111000001
1011C0011C00001
1000000110000E1
111111111111111
