111111111111111
110P000011111C1
100010C0000P001
101111111000001
1011C0011C00E01
1000000110000E1
111111111111111
