111111111111111
110P000011111C1
100010C00000001
1011111110000011
1011C0011C00001
1000000110000E1
111111111111111
