111111111111111111111111
100000000000000000000001
1010010C0101001000P01101
101001010001001000000101
101000C10100001000000101
101000010101001000E01101
100000000000000000000001
111111111111111111111111
