111111111111111111111111
10000000000000000000C001
1010010C0101001000011111
1010010100010C1000001E01
101000C10100001000001101
1010000101010P1000001101
100000000000000000000001
111111111111111111111111
