111111111111111111111111
100000000000000000000001
101001010101001000001101
101001010001001000000101
101000010100001000000101
101000010101001000001101
100000000000000000000001
111111111111111111111111
