111111111111111111111111
10000001000000000000C001
1010010C0101001000011111
101001000000001000001E01
1010C00101C100110C101101
1011100101110P1001001101
1C1100010000000000000001
111111111111111111111111
