111111111111111111111111
100000000000000000000001
1010010C0101001000001101
101001010001001000000101
101000C10100001000000101
101000010101001P00E01101
100000000000000000000001
111111111111111111111111
