111111111111111
110P000010011C1
100010C00000001
101111111000001
1011C0010C00111
1001000110001E1
101111010C00001
100100011000101
100000C10C00101
111111111111111
